000000000000000000000000000000000000000000000000
000000000000000000000000000000000000000000000000
000000000000000000000000000000000000000000000000
000000000000000000000000000000000000000000000000
000000000000000000000000000000000000000000000000
000000000000000000000000000000000000000000000000
000005000000000000000000000000000000000000000000
000011000000000000000000000000000000000000000000
000000000000000000000000000000000000000000000000
000000000000000000000000000000000000000000000000
111100011111111111133222222221331111111111111141
888800088888888888833883333333338888888888888888
888800088888888888833883333333338888888888888888
888800088888888888833333333333888888888888888888
888855588888888888833333333388888888888888888888
888888888888888888833333333888888888888888888888
888888888888888888888888888888888888888888888888