8888888888888888888888888888888888888888888888888888888888888888888888888888888888888888888888888
8888888888888888888888888888888888888888888888888888888888888888888888888888888888888888888888888
8888888888888888888888888888888888888888888888888888888888888888888888888888888888888888888888888
0000000000000000888888888880000000000000088888888888888888888888888888888888888888888888888888888
0000000000000000000000000000000000000000000000888888888888888888888888888888888888888888888888888
1111111111111100000000000000000000000000000000000000000000888888888888888888888888888888888888888
8888888888888888888888888888222133312222111000000000000000888888888888888888888888888888888888888
8888888888888888888888888888888899988888888111110011111111888888888888888888888888888888888888888
8888888888888888888888888888888888888888888888880088888888888888888888888888888888888888888888888
8800008888888888888888888888888888888888888888880088888888888888888888888888888888888888888888888
8800008888888888888888888888888888888888888888880088888888888888888888888888888888888888888888888
8800000000000000000000000000000000000000000000000088888888888888888888888888888888888888888888888
8800000000000000000000000000000000000000000000000000000068888888888888888888888888888888888888888
8800688888888888888888888888888880088888888888888888888888888888888888888888888888888888888888888
8800088888888888888888888888888880008888888888888888888888888888888888888888888888888888888888888
8800088888888888888888888888888880000000000000000008888888888888888888888888888888888888888888888
8800008888888888888888888888888888800000000000000008888888888888888888888888888888888888888888888
8855000000000000000000000000000000000000000000088888888888888888888888888888888888888888888888888
8888888888888888888008888888888888888888888880088888888888888888888888888888888888888888888888888
8800000000000000000000000000000000000000000000088888888888888888888888888888888888888888888888888
8800000000000000000000000000000000000000000000068888888888888888888888888888888888888888888888888
8888888888888888888888888888880022222200222222888888888888888888888888888888888888888888888888888
8800000000000000000000000000000080000000000000000888888888888888888888888888888888888888888888888
8800000000000000000000000000000080000000000000000888888888888888888888888888888888888888888888888
8111333333333333333333333333333333331111111111140888888888888888888888888888888888888888888888888
9999999999999999999999999999999999998888888888880888888888888888888888888888888888888888888888888