000000000000000000000000000000000000000000000000
000000000000000000000000000000000000000000000000
000000000000000000000000000000000000000000000000
000000000000000000000000000000000000000000000000
000000000000000000000000000000000000000000000000
000000000000000000000000000000000000000000000000
000000000000000000000000000000000000000000000000
000000000000000000000000000000000000000000000000
000000000000000000000000000000000000000000000000
000000000000000000000000000000000000000000000000
000000000000000000000000000000000000000000000000
000000000000000000000000000000000000000000000000
000000000000000000000000000000000000000000000000
000000000000000000000000000000000000000000000000
000000000000000000000000000000000000000000000000
000000000000000000000000000000000000000000000000
000000000000000000000000000000000000000000000000
000000000000000000000000000000000000000000000000
000000000000000000000000000000000000000000000000
000000000000000000000000000000000000000000000000
000000000000000000000000000000000000000000000000
000000000000000000000000000000000000000000000000
000000000000000000000000000000000000000000000000
000000000000000000000000000000000000000000000000
000000000000000000000000000000000000000000000000
000000000000000000000000000000000000000000000000
000000000000000000000000000000000000000000000000
000000000000000000000000000000000000000000000000
000000000000000000000000000000000000000000000000
000000000000000000000000000000000000000000000000
000000000000000000000000000000000000000000000000
000000000000000000000000000000000000000000000000
000000000000000000000000000000000000000000000000
000000000000000000000000000000000000000000000000
000000000000000000000000000000000000000000000000
111111111188811111111411111111111222221222200011
888888888888888888888888888888888888888888800088
888888888888888888888888888888888888888888800088
888888888888888888888888888888888888888888800188
888888888888888888888888888888888800000000000088
888888888888888888888888888888888800000000000088
888888888888888888888888880000000000000888888888
888888888888888888888888880000000000000888888888
888888888888888888888888888888888800000888888888
888888888888888888888888888888888800088888888888
888888888888888888888888888888888800008888888888
888888888888888888888888888888888810000888888888
888888888888888888888888888888800001000000888888
888888888888888888888888888888800000000000888888
888888888888888888888880000000000000000100888888
888888888888888888888880000000000000000000888888
888888888888888888880000000000000000000000888888
888888888888888888880000000000000000100000888888
888888888888888888800000000000000000000000888888
888888888888888888855500000880888800008888888888
888888888888888888888800000885888855558888888888
888888888888888888888800000888888888888888888888
888888888888888888888800000888888888888888888888
888888888888888888888810001888888888888888888888
888888888888888888888880018888888888888888888888
888888888888888888888880068888888888888888888888
888888888888888888888800000000000000000000000000
888888888888888888888800000000000000000000000000
888888888888888888888800000000000000000000000000
888888888888888888888888888888888888888800008888
888888888888888888888888888888888888888000008888
888888888888888888888888888888888888888000008888
888888888888888888888888888888888888888000008888
888888888888888888888888888888888888888000018888
888888888888888888888888888888888888888000008888
880000000888880000000000000000000000088010058888
880000000088880000000000000000000000088500088888
880000000000000000000000000000000000000000000088
880000000000000000000000000000000000000000000088
888888888222888883338800088800888822288888888888
888888888888888888888855588855888888888888888888