000000000000000000000000000000000000000000000000
000000000000000000000000000000000000000000000000
000000000000000000000000000000000000000000000000
000000000000000000000000000000000000000000000000
000000000000000000000000000000000000000000000004
000000000000000000000000000000000000000000000018
000000000000000000000000000000000000000000000188
000000000000000000000000000000000000000000001888
000000000000000000000000000000000000000000018888
000000000000000000000000000000000000000000188888
000000000000000000000000000000000000000001888888
000000000000000000000617000000000000000018888888
000000006170000617000000000000000000000188888888
000000000000000000000000000000000000001888888888
111111000000000000000111111111111111118888888888
888888555555555555555888888888888888888888888888
888888888888888888888888888888888888888888888888
888888888888888888888888888888888888888888888888
888888888888888888888888888888888888888888888888