000000000000000000000000000000000000000000000000
000000000000000000000000000000000000000000000000
000000000000000000000000000000000000000000000000
000000000000000000000000000000000000000000000000
000000000000000000000000000000000000000000000000
000000000000000000000000000000000000000000000000
000000000000000000000000000000000000000000000000
111111111133311111111111111111111222222222220011
833333333333333333333333333333333888888888880088
833333333333333333333333333333333333333333380088
888888888833333333333333333333888888888888880088
888888888888883333333333333333888800000000000088
883333333333333333333338888888888800000000000088
833333333333333333333333380000000000000888888888
833333333333333333333333380000000000000888888888
833333333333333333333333388888888800000888888888
833333333333333333333333333333333800088888888888
888833333333333333333333888888888800008888888888
833333333333333333388888888888888800000888888888
883333333333333333333388888888800000000000888888
888883333333333333333388888888800000000000888888
833333333333888888888880000000000000000000888888
888888888333333338888880000000000000000000888888
888888888333333338880000000000000000000000888888
888888888888833888880000000000000000000000888888
888833333333333888800000000000000000000000888888
888888388888888888855500005555888855558888888888
888888388888888888888870068888888888888888888888
888888388888888888888870068888888888888888888888
888888333333888888888870068888888888888888888888
888888888883333333888870068888888888888888888888
888888888888888333333870068888888888888888888888
888888888888888883338870068888888888888888888888
888833333333333333338800000000000000000000000000
888833333333333333338800000000000000000000000000
888833333333333333338800000000000000000000000000
888833333333333333338888888888888888888000008888
888888333333333388888888888888888888888000008888
888888883333338888888888888888888888888000008888
888888888333338888888888888888888888888000008888
883333333333888888888888888888888888888000008888
888883333888888888888888888888888888888000008888
883333333888888888888888888888888888888000058888
888883333333333388888888888888888888888500088888
888333333333333333333333333333333333333384008888
888888888888888888888888888888888888888333338888
888888888888888888888888888888888888888888888888