0000000000000000000000000000000000000000000000
0000000000000000000000000000000000000000000000
0000000000000000000000000000000000000000000000
0000000000000000000000000000000000000000000000
0000000000000000000000000000000000000000000000
0000000000000000000000000000000000000000000000
1111111111000111111222222221111133111000001411
8888888888000888888222222228888899888555558888
8888888888000888888222222228888833888888888888
8888888888555888888222222228888833888888888888
8888888888888888888888888888888888888888888888